Codes	Name	Organizations
NG	Nigeria The Federal Republic of Nigeria	United Nations
AD	Andorra The Principality of Andorra	United Nations
AE	United Arab Emirates The United Arab Emirates	United Nations
AF	Afghanistan The Islamic Republic of Afghanistan	United Nations
AG	Antigua and Barbuda	United Nations
AI	Anguilla	
AL	Albania The Republic of Albania	NATO United Nations
AM	Armenia The Republic of Armenia	United Nations
AO	Angola The Republic of Angola	United Nations
AQ	Antartica	
AR	Argentina The Argentine Republic	United Nations
AS	American Samoa The Territory of American Samoa	
AT	Austria The Republic of Austria	European Union United Nations
AU	Australia The Commonwealth of Australia	United Nations
AW	Aruba	
AX	Åland Islands Åland	
AZ	Azerbaijan The Republic of Azerbaijan	United Nations
BA	Bosnia and Herzegovina	United Nations
BB	Barbados	United Nations
BD	Bangladesh The People's Republic of Bangladesh	United Nations
BE	Belgium The Kingdom of Belgium	European Union NATO United Nations
BF	Burkina Faso	United Nations
BG	Bulgaria The Republic of Bulgaria	European Union NATO United Nations
BH	Bahrain The Kingdom of Bahrain	United Nations
BI	Burundi The Republic of Burundi	United Nations
BJ	Benin The Republic of Benin	United Nations
BL	Saint Barthélemy The Collectivity of Saint-Barthélemy	
BM	Bermuda	
BN	Brunei Darussalam The Nation of Brunei, the Abode of Peace	United Nations
BO	Bolivia The Plurinational State of Bolivia	United Nations
BQ	Caribbean Netherlands Bonaire, Sint Eustatius and Saba	
BR	Brazil The Federative Republic of Brazil	United Nations
BS	Bahamas The Commonwealth of The Bahamas	United Nations
BT	Bhutan The Kingdom of Bhutan	United Nations
BV	Bouvet Island	
BW	Botswana The Republic of Botswana	United Nations
BY	Belarus The Republic of Belarus	United Nations
BZ	Belize	United Nations
CA	Canada	NATO United Nations
CC	Cocos (Keeling) Islands The Territory of Cocos (Keeling) Islands	
CD	Democratic Republic of the Congo The Democratic Republic of the Congo	United Nations
CF	Central African Republic The Central African Republic	United Nations
CG	Republic of the Congo The Republic of the Congo	United Nations
CH	Switzerland The Swiss Confederation	United Nations
CI	Ivory Coast The Republic of Côte d'Ivoire	United Nations
CK	Cook Islands The Cook Islands	
CL	Chile The Republic of Chile	United Nations
CM	Cameroon The Republic of Cameroon	United Nations
CN	China The People's Republic of China	United Nations
CO	Colombia The Republic of Colombia	United Nations
CR	Costa Rica The Republic of Costa Rica	United Nations
CU	Cuba The Republic of Cuba	United Nations
CV	Cape Verde The Republic of Cabo Verde	United Nations
CW	Curaçao The Country of Curaçao	
CX	Christmas Island The Territory of Christmas Island	
CY	Cyprus The Republic of Cyprus	European Union United Nations
CZ	Czechia The Czech Republic	European Union NATO United Nations
DE	Germany The Federal Republic of Germany	European Union NATO United Nations
DJ	Djibouti The Republic of Djibouti	United Nations
DK	Denmark The Kingdom of Denmark	European Union NATO United Nations
DM	Dominica The Commonwealth of Dominica	United Nations
DO	Dominican Republic The Dominican Republic	United Nations
DZ	Algeria The People's Democratic Republic of Algeria	United Nations
EC	Ecuador The Republic of Ecuador	United Nations
EE	Estonia The Republic of Estonia	European Union NATO United Nations
EG	Egypt The Arab Republic of Egypt	United Nations
EH	Western Sahara The Sahrawi Arab Democratic Republic	
ER	Eritrea The State of Eritrea	United Nations
ES	Spain The Kingdom of Spain	European Union NATO United Nations
ET	Ethiopia The Federal Democratic Republic of Ethiopia	United Nations
FI	Finland The Republic of Finland	European Union NATO United Nations
FJ	Fiji The Republic of Fiji	United Nations
FK	Falkland Islands The Falkland Islands	
FM	Micronesia The Federated States of Micronesia	United Nations
FO	Faroe Islands The Faroe Islands	
FR	France The French Republic	European Union NATO United Nations
GA	Gabon The Gabonese Republic	United Nations
GB	United Kingdom The United Kingdom of Great Britain and Northern Ireland	NATO United Nations
GD	Grenada	United Nations
GE	Georgia	United Nations
GF	French Guiana Guyane	
GG	Guernsey The Bailiwick of Guernsey	
GH	Ghana The Republic of Ghana	United Nations
GI	Gibraltar	
GL	Greenland Kalaallit Nunaat	
GM	Gambia The Republic of The Gambia	United Nations
GN	Guinea The Republic of Guinea	United Nations
GP	Guadeloupe	
GQ	Equatorial Guinea The Republic of Equatorial Guinea	United Nations
GR	Greece The Hellenic Republic	European Union NATO United Nations
GS	South Georgia and the South Sandwich Islands	
GT	Guatemala The Republic of Guatemala	United Nations
GU	Guam The Territory of Guam	
GW	Guinea-Bissau The Republic of Guinea-Bissau	United Nations
GY	Guyana The Co-operative Republic of Guyana	United Nations
HK	Hong Kong The Hong Kong Special Administrative Region of China	
HM	Heard Island and McDonald Islands The Territory of Heard Island and McDonald Islands	
HN	Honduras The Republic of Honduras	United Nations
HR	Croatia The Republic of Croatia	European Union NATO United Nations
HT	Haiti The Republic of Haiti	United Nations
HU	Hungary	European Union NATO United Nations
ID	Indonesia The Republic of Indonesia	United Nations
IE	Ireland	European Union United Nations
IL	Israel The State of Israel	United Nations
IM	Isle of Man The Isle of Man	
IN	India The Republic of India	United Nations
IO	British Indian Ocean Territory The British Indian Ocean Territory	
IQ	Iraq The Republic of Iraq	United Nations
IR	Iran The Islamic Republic of Iran	United Nations
IS	Iceland	NATO United Nations
IT	Italy The Italian Republic	European Union NATO United Nations
JE	Jersey The Bailiwick of Jersey	
JM	Jamaica	United Nations
JO	Jordan The Hashemite Kingdom of Jordan	United Nations
JP	Japan	United Nations
KE	Kenya The Republic of Kenya	United Nations
KG	Kyrgyzstan The Kyrgyz Republic	United Nations
KH	Cambodia The Kingdom of Cambodia	United Nations
KI	Kiribati The Republic of Kiribati	United Nations
KM	Comoros The Union of the Comoros	United Nations
KN	Saint Kitts and Nevis	United Nations
KP	North Korea The Democratic People's Republic of Korea	United Nations
KR	South Korea The Republic of Korea	United Nations
KW	Kuwait The State of Kuwait	United Nations
KY	Cayman Islands The Cayman Islands	
KZ	Kazakhstan The Republic of Kazakhstan	United Nations
LA	Laos The Lao People's Democratic Republic	United Nations
LB	Lebanon The Lebanese Republic	United Nations
LC	Saint Lucia	United Nations
LI	Liechtenstein The Principality of Liechtenstein	United Nations
LK	Sri Lanka The Democratic Socialist Republic of Sri Lanka	United Nations
LR	Liberia The Republic of Liberia	United Nations
LS	Lesotho The Kingdom of Lesotho	United Nations
LT	Lithuania The Republic of Lithuania	European Union NATO United Nations
LU	Luxembourg The Grand Duchy of Luxembourg	European Union NATO United Nations
LV	Latvia The Republic of Latvia	European Union NATO United Nations
LY	Libya The State of Libya	United Nations
MA	Morocco The Kingdom of Morocco	United Nations
MC	Monaco The Principality of Monaco	United Nations
MD	Moldova The Republic of Moldova	United Nations
ME	Montenegro	NATO United Nations
MF	Saint Martin The Collectivity of Saint-Martin	
MG	Madagascar The Republic of Madagascar	United Nations
MH	Marshall Islands The Republic of the Marshall Islands	United Nations
MK	North Macedonia Republic of North Macedonia	NATO United Nations
ML	Mali The Republic of Mali	United Nations
MM	Myanmar The Republic of the Union of Myanmar	United Nations
MN	Mongolia The State of Mongolia	United Nations
MO	Macao Macao Special Administrative Region of China	
MP	Northern Mariana Islands The Commonwealth of the Northern Mariana Islands	
MQ	Martinique	
MR	Mauritania The Islamic Republic of Mauritania	United Nations
MS	Montserrat	
MT	Malta The Republic of Malta	European Union United Nations
MU	Mauritius The Republic of Mauritius	United Nations
MV	Maldives The Republic of Maldives	United Nations
MW	Malawi The Republic Malawi	United Nations
MX	Mexico The United Mexican States	United Nations
MY	Malaysia	United Nations
MZ	Mozambique The Republic of Mozambique	United Nations
NA	Namibia The Republic of Namibia	United Nations
NC	New Caledonia	
NE	Niger The Republic of the Niger	United Nations
NF	Norfolk Island The Territory of Norfolk Island	
NI	Nicaragua The Republic of Nicaragua	United Nations
NL	Netherlands The Kingdom of the Netherlands	European Union NATO United Nations
NO	Norway The Kingdom of Norway	NATO United Nations
NP	Nepal The Federal Democratic Republic of Nepal	United Nations
NR	Nauru The Republic of Nauru	United Nations
NU	Niue	
NZ	New Zealand	United Nations
OM	Oman The Sultanate of Oman	United Nations
PA	Panama The Republic of Panamá	United Nations
PE	Peru The Republic of Perú	United Nations
PF	French Polynesia	
PG	Papua New Guinea The Independent State of Papua New Guinea	United Nations
PH	Philippines The Republic of the Philippines	United Nations
PK	Pakistan The Islamic Republic of Pakistan	United Nations
PL	Poland The Republic of Poland	European Union NATO United Nations
PM	Saint Pierre and Miquelon The Overseas Collectivity of Saint-Pierre and Miquelon	
PN	Pitcairn Islands The Pitcairn, Henderson, Ducie and Oeno Islands	
PR	Puerto Rico The Commonwealth of Puerto Rico	
PS	Palestine The State of Palestine	
PT	Portugal The Portuguese Republic	European Union NATO United Nations
PW	Palau The Republic of Palau	United Nations
PY	Paraguay The Republic of Paraguay	United Nations
QA	Qatar The State of Qatar	United Nations
RE	Réunion	
RO	Romania	European Union NATO United Nations
RS	Serbia The Republic of Serbia	United Nations
RU	Russian Federation The Russian Federation	United Nations
RW	Rwanda The Republic of Rwanda	United Nations
SA	Saudi Arabia The Kingdom of Saudi Arabia	United Nations
SB	Solomon Islands The Solomon Islands	United Nations
SC	Seychelles The Republic of Seychelles	United Nations
SD	Sudan The Republic of the Sudan	United Nations
SE	Sweden The Kingdom of Sweden	European Union NATO United Nations
SG	Singapore The Republic of Singapore	United Nations
SH	Saint Helena, Ascension and Tristan da Cunha	
SI	Slovenia The Republic of Slovenia	European Union NATO United Nations
SJ	Svalbard and Jan Mayen	
SK	Slovakia The Slovak Republic	European Union NATO United Nations
SL	Sierra Leone The Republic of Sierra Leone	United Nations
SM	San Marino The Republic of San Marino	United Nations
SN	Senegal The Republic of Senegal	United Nations
SO	Somalia The Federal Republic of Somalia	United Nations
SR	Suriname The Republic of Suriname	United Nations
SS	South Sudan The Republic of South Sudan	United Nations
ST	Sao Tome and Principe The Democratic Republic of São Tomé and Príncipe	United Nations
SV	El Salvador The Republic of El Salvador	United Nations
SX	Sint Maarten	
SY	Syrian Arab Republic The Syrian Arab Republic	United Nations
SZ	Eswatini The Kingdom of Eswatini	United Nations
TC	Turks and Caicos Islands The Turks and Caicos Islands	
TD	Chad The Republic of Chad	United Nations
TF	French Southern Territories The French Southern and Antarctic Lands	
TG	Togo The Togolese Republic	United Nations
TH	Thailand The Kingdom of Thailand	United Nations
TJ	Tajikistan The Republic of Tajikistan	United Nations
TK	Tokelau	
TL	Timor-Leste The Democratic Republic of Timor-Leste	United Nations
TM	Turkmenistan	United Nations
TN	Tunisia The Republic of Tunisia	United Nations
TO	Tonga The Kingdom of Tonga	United Nations
TR	Turkey The Republic of Turkey	NATO United Nations
TT	Trinidad and Tobago The Republic of Trinidad and Tobago	United Nations
TV	Tuvalu	United Nations
TW	Taiwan The Republic of China	
TZ	Tanzania The United Republic of Tanzania	United Nations
UA	Ukraine	United Nations
UG	Uganda The Republic of Uganda	United Nations
UM	United States Minor Outlying Islands Baker Island, Howland Island, Jarvis Island, Johnston Atoll, Kingman Reef, Midway Atoll, Navassa Island, Palmyra Atoll, and Wake Island	
UN	United Nations The United Nations	
US	United States The United States of America	NATO United Nations
UY	Uruguay The Oriental Republic of Uruguay	United Nations
UZ	Uzbekistan The Republic of Uzbekistan	United Nations
VA	Vatican City The Holy See	
VC	Saint Vincent and the Grenadines	United Nations
VE	Venezuela The Bolivarian Republic of Venezuela	United Nations
VG	British Virgin Islands The Virgin Islands	
VI	United States Virgin Islands The Virgin Islands of the United States	
VN	Vietnam The Socialist Republic of Vietnam	United Nations
VU	Vanuatu The Republic of Vanuatu	United Nations
WF	Wallis and Futuna The Territory of the Wallis and Futuna Islands	
WS	Samoa The Independent State of Samoa	United Nations
XK	Kosovo The Republic of Kosovo	
YE	Yemen The Republic of Yemen	United Nations
YT	Mayotte The Department of Mayotte	
ZA	South Africa The Republic of South Africa	United Nations
ZM	Zambia The Republic of Zambia	United Nations
ZW	Zimbabwe The Republic of Zimbabwe	United Nations